╒══════════════╤═══════════╤════════════╤════════════╤════════════╤════════════╤════════════╤════════════╤════════════╕
│              │    W1     │     W2     │     W3     │     W4     │     W5     │     W6     │     W7     │     W8     │
╞══════════════╪═══════════╪════════════╪════════════╪════════════╪════════════╪════════════╪════════════╪════════════╡
│ mgb_basic    │ 0.0021823 │ 0.00142357 │ 0.00128342 │ 0.00128446 │ 0.00171402 │ 0.00235392 │ 0.00151868 │ 0.00161841 │
├──────────────┼───────────┼────────────┼────────────┼────────────┼────────────┼────────────┼────────────┼────────────┤
│ ai-mgb_basic │  11.6374  │  11.2815   │  7.27242   │  7.64024   │   6.8619   │  14.7389   │   7.7614   │  16.2718   │
╘══════════════╧═══════════╧════════════╧════════════╧════════════╧════════════╧════════════╧════════════╧════════════╛