╒══════════════╤════════════╤════════════╤════════════╤════════════╤════════════╤════════════╤════════════╤════════════╕
│              │     W1     │     W2     │     W3     │     W4     │     W5     │     W6     │     W7     │     W8     │
╞══════════════╪════════════╪════════════╪════════════╪════════════╪════════════╪════════════╪════════════╪════════════╡
│ mgb_basic    │ 0.00195314 │ 0.00245847 │ 0.00126843 │ 0.00160066 │ 0.00144036 │ 0.00210216 │ 0.00245915 │ 0.00142077 │
├──────────────┼────────────┼────────────┼────────────┼────────────┼────────────┼────────────┼────────────┼────────────┤
│ ai-mgb_basic │  9.58614   │  14.1526   │  7.16405   │   14.615   │   10.147   │  23.4142   │  25.2488   │  24.3995   │
╘══════════════╧════════════╧════════════╧════════════╧════════════╧════════════╧════════════╧════════════╧════════════╛